{
  "level_id": 5,
  "name": "The Final Throne",
  "emperor_state": "triumphant",
  "boss_name": "The Dark Emperor",
  "boss_hp": 14,
  "tile_types": {
    "1": "Bamboo",  "2": "Coin",   "3": "Dragon", "4": "Wind",
    "5": "Flower",  "6": "Season", "7": "Gem",    "8": "Phoenix",
    "9": "Tiger",  "10": "Cloud"
  },
  "tiles": [
    { "id": 1,  "x": 0, "y": 0, "z": 0 },
    { "id": 2,  "x": 1, "y": 0, "z": 0 },
    { "id": 2,  "x": 2, "y": 0, "z": 0 },
    { "id": 1,  "x": 3, "y": 0, "z": 0 },
    { "id": 3,  "x": 0, "y": 1, "z": 0 },
    { "id": 4,  "x": 1, "y": 1, "z": 0 },
    { "id": 4,  "x": 2, "y": 1, "z": 0 },
    { "id": 3,  "x": 3, "y": 1, "z": 0 },
    { "id": 5,  "x": 0, "y": 2, "z": 0 },
    { "id": 6,  "x": 1, "y": 2, "z": 0 },
    { "id": 6,  "x": 2, "y": 2, "z": 0 },
    { "id": 5,  "x": 3, "y": 2, "z": 0 },
    { "id": 7,  "x": 0, "y": 3, "z": 0 },
    { "id": 8,  "x": 1, "y": 3, "z": 0 },
    { "id": 8,  "x": 2, "y": 3, "z": 0 },
    { "id": 7,  "x": 3, "y": 3, "z": 0 },
    { "id": 9,  "x": 0, "y": 4, "z": 0 },
    { "id": 10, "x": 1, "y": 4, "z": 0 },
    { "id": 10, "x": 2, "y": 4, "z": 0 },
    { "id": 9,  "x": 3, "y": 4, "z": 0 },
    { "id": 1,  "x": 1, "y": 0, "z": 1 },
    { "id": 1,  "x": 2, "y": 0, "z": 1 },
    { "id": 2,  "x": 1, "y": 1, "z": 1 },
    { "id": 2,  "x": 2, "y": 1, "z": 1 },
    { "id": 3,  "x": 1, "y": 2, "z": 1 },
    { "id": 3,  "x": 2, "y": 2, "z": 1 },
    { "id": 4,  "x": 1, "y": 3, "z": 1 },
    { "id": 4,  "x": 2, "y": 3, "z": 1 },
    { "id": 5,  "x": 1, "y": 0, "z": 2 },
    { "id": 5,  "x": 2, "y": 0, "z": 2 },
    { "id": 6,  "x": 1, "y": 1, "z": 2 },
    { "id": 6,  "x": 2, "y": 1, "z": 2 }
  ]
}
